1111111111111111111111111111111111111111111111111111
1000000000000000000000000000000001111111111111111111
10P00000000000000000000000C0000001111111111111111111
1000000000000000000000000000000001111111111111111111
10000C0000000000000000000000000001111111111111111111
1000000000000000000000000000000001111111111111111111
1000000000000000000000000000000001111111111111111111
1000000000000000000000000000000001111111111111111111
100000000C000000000000000000000001111111111111111111
1000000000000000000000000000000001111111111111111111
1000000000000000000000000000000001111111111111111111
1000000000000000000000000000000001111111111111111111
1000000000000000000C00000000000001111111111111111111
1000000000000000000000000000000001111111111111111111
1000000000000000000000000000000001111111111111111111
10000000000000000000000000000C0001111111111111111111
1000000000000000000000000000000001111111111111111111
1000000C00000000000000000000000E01111111111111111111
1000000000000000000000000000000001111111111111111111
1111111111111111111111111111111111111111111111111111
1111111111111111111111111111111111111111111111111111
1111111111111111111111111111111111111111111111111111
1111111111111111111111111111111111111111111111111111
1111111111111111111111111111111111111111111111111111
1111111111111111111111111111111111111111111111111111
1111111111111111111111111111111111111111111111111111
1111111111111111111111111111111111111111111111111111
1111111111111111111111111111111111111111111111111111
1111111111111111111111111111111111111111111111111111
1111111111111111111111111111111111111111111111111111
1111111111111111111111111111111111111111111111111111
1111111111111111111111111111111111111111111111111111
1111111111111111111111111111111111111111111111111111
1111111111111111111111111111111111111111111111111111
1111111111111111111111111111111111111111111111111111
1111111111111111111111111111111111111111111111111111
1111111111111111111111111111111111111111111111111111
1111111111111111111111111111111111111111111111111111
1111111111111111111111111111111111111111111111111111
1111111111111111111111111111111111111111111111111111
1111111111111111111111111111111111111111111111111111
1111111111111111111111111111111111111111111111111111
1111111111111111111111111111111111111111111111111111
1111111111111111111111111111111111111111111111111111
1111111111111111111111111111111111111111111111111111
1111111111111111111111111111111111111111111111111111
1111111111111111111111111111111111111111111111111111
1111111111111111111111111111111111111111111111111111
1111111111111111111111111111111111111111111111111111
1111111111111111111111111111111111111111111111111111
1111111111111111111111111111111111111111111111111111
1111111111111111111111111111111111111111111111111111
1111111111111111111111111111111111111111111111111111
1111111111111111111111111111111111111111111111111111
1111111111111111111111111111111111111111111111111111
1111111111111111111111111111111111111111111111111111
1111111111111111111111111111111111111111111111111111
1111111111111111111111111111111111111111111111111111